..................................................
..................................................
....h..h..h..h..h..h..h..h..h..h..h..h..h..h......
...v..........................................v...
........h..h..h..h..h..h..h..h..h..h..h...........
.....v......................................v.....
...v....v................................v....v...
..................................................
.....v......................................v.....
...v....v................................v....v...
...............h..h..h..h..h..h..h................
.....v......................................v.....
...v....v.....v...................v......v....v...
..................................................
.....v..................t...................v.....
...v....v.....v...................v......v....v...
..................................................
.....v......................................v.....
...v....v.....v...................v......v....v...
..................................................
.....v.........h..h..h.....h..h..h..........v.....
...v....v................................v....v...
..................................................
.....v......................................v.....
...v....v................................v....v...
..................................................
.....v......................................v.....
...v....v................................v....v...
..................................................
.....v......................................v.....
...v....v................................v....v...
..................................................
.....v......................................v.....
...v...h..h..h..h..h..h..h..h..h..h..h..h..h..v...
..................................................
..................................................
...v..........................................v...
......h..h..h..h..h..h..h..h..h..h..h..h..h..h....
..................................................
..................................................
..................................................
..................................................
..................................................
..................................................
..................................................
..................................................
..................................................
..................................................
..................................................
..................................................