..................................................
..................................................
..................rrrrrrrrrrrrrr..................
..................rrrrrrrrrrrrrr..................
..................rr..........rr..................
..................rr..........rr..................
..................rr..........rr..................
..................rr..........rr..................
..................rr..........rr..................
..................rr..........rr..................
..................rr..........rr..................
..................rr..........rr..................
..................rr..........rr..................
..................rr..........rr..................
..................rr..........rr..................
..................rr..........rr..................
..................rr..........rr..................
..................rr..........rr..................
..................rr..........rr..................
..................rr..........rr..................
..................rr..........rr..................
..................rr..........rr..................
..................rr..........rr..................
..................rr..........rr..................
..................rr..........rr..................
..................rr..........rr..................
..................rr..........rr..................
..................rr..........rr..................
..................rr..........rr..................
..................rr..........rr..................
..................rr..........rr..................
..................rr..........rr..................
..................rr..........rr..................
..................rr..........rr..................
..................rr..........rr..................
..................rr..........rr..................
..................rr..........rr..................
..................rr..........rr..................
..................rr..........rr..................
..................rr..........rr..................
...rrrrrrrrrrrrrrrrr..........rrrrrrrrrrrrrrrrr...
...rrrrrrrrrrrrrrrrr..........rrrrrrrrrrrrrrrrr...
...rr........................................rr...
...rr........................................rr...
...rr........................................rr...
...rr........................................rr...
...rrrrrrrrrrrrrrrrr..........rrrrrrrrrrrrrrrrr...
...rrrrrrrrrrrrrrrrr..........rrrrrrrrrrrrrrrrr...
..................rr..........rr..................
..................rr..........rr..................