ssssssssssssssssssssssssssssssssssssssssssssssssss
s.......................rr.......................s
s.......................rr.......................s
s.......................rr.......................s
s.......................rr.......................s
s.......................rr.......................s
s.......................rr.......................s
s.......................rr.......................s
s.......................rr.......................s
s.......................rr.......................s
s.......................rr.......................s
s.......................rr.......................s
s.......................rr.......................s
s.......................rr.......................s
s.......................rr.......................s
s.......................rr.......................s
s.......................rr.......................s
s.......................rr.......................s
s.......................rr.......................s
s.......................rr.......................s
s.......................rr.......................s
s.......................rr.......................s
s.......................rr.......................s
s.......................rr.......................s
s.......................rr.......................s
s.......................rr.......................s
s.......................rr.......................s
s.......................rr.......................s
s.......................rr.......................s
s.......................rr.......................s
s.......................rr.......................s
s.......................rr.......................s
s.......................rr.......................s
s.......................rr.......................s
s.......................rrrrrrrrrrrrrrrrrr.......s
s.......................rrrrrrrrrrrrrrrrrr.......s
s.......................................rr.......s
s.......................................rr.......s
s.......................................rr.......s
s.......................................rr.......s
s.......................................rr.......s
s.......................................rr.......s
s.......................................rr.......s
s.......................................rr.......s
s.......................................rr.......s
s.......................................rr.......s
s........................rrrrrrrrrrrrrrrrr.......s
s........................rrrrrrrrrrrrrrrrr.......s
s........................rr......................s
ssssssssssssssssssssssssssssssssssssssssssssssssss